                    
                    
  ................. 
  .###############. 
  .#.............#. 
  .#.           .#. 
  .#.           .#. 
  .#.           .#. 
  .#.........   .#. 
  .######..#.   .#. 
  .........#.   .#. 
          .#.   .#. 
          .#.   .#. 
          .#.   .#. 
          .#.   .#. 
          .#.   .#. 
          .#.....#. 
          .#######. 
          ......... 
                    
